1111111111111111111
1P00000000000000001
1000000000000000001
1000000000000000001
1111111000011111111
1CCCCC1CCCC1CCCCCC1
1000000100100000001
1000000000000000001
10000000000000000E1
1111111111111111111
