WE           ./assets/NO.xpm
NO                     ./assets/SO.xpm
SO                                ./assets/WE.xpm
EA                      ./assets/EA.xpm



F                                220,100,000



C                          225,255,000


111111
100001
100N01
100001
111111